15
5
***************
#  **    ******
** ** ** ******
**    ** ******
********      $
***************